{
  "id": "zone2_antre_velours_noir",
  "name": "L'Antre de Velours Noir",
  "act": 1,
  "ambiance": "Obscurité presque totale, chaînes, symboles du clan",
  "palette": "ACT_1",
  "notes": "Layout procédural (scripts/gen-zones.mjs) — grande zone multi-écrans avec plateformes et obstacles liés aux pouvoirs.",
  "cols": 145,
  "rows": 15,
  "tiles": [
    ".................................................................................................................................................",
    ".................................................................................................................................................",
    ".................................................................................................................................................",
    "........................................................................##................................................##...##...##...###.....",
    "..........###......##............................................................................................................................",
    "...................................................................................................................##............................",
    "........................###....###...............................##............................................................###...............",
    ".....##....###...................................................................................................................................",
    "....................................C..........###............................##..............................##........###......................",
    "......................#....#########C.....................###..........##...........................##...............................###.........",
    "#############..########....#############.......................................................................C.................................",
    "#############..########....########################.....................C....#######...###................#####C....#########....#...............",
    "#############..########....#############################..######..######C#..########...######...#####....#######....#########....####...#########",
    "#############..########....#############################..######..##################...######...#####....#######....#########....####...#########",
    "#############..########....#############################..######..##################...######...#####....#######....#########....####...#########"
  ],
  "entities": [
    {
      "type": "spawn",
      "x": 4,
      "y": 9,
      "requiresPower": "griffes_renforcees"
    },
    {
      "type": "npc",
      "x": 29,
      "y": 8,
      "dialogTree": "tozen_zone2_hint",
      "optional": true
    },
    {
      "type": "boss_arena",
      "x": 124,
      "y": 10,
      "bossId": "boss_maitre_aveugle",
      "grantsPower": "vision_feline"
    },
    {
      "type": "zone_exit",
      "x": 140,
      "y": 11,
      "targetZone": "zone3_velkhar_foyer_ombres",
      "requiresBossDefeated": "boss_maitre_aveugle"
    }
  ]
}
