{
  "id": "zone7_salle_miroirs",
  "name": "La Salle des Miroirs",
  "act": 2,
  "ambiance": "Réflexions de Kiba, puzzles lumière/ombre, illusions",
  "palette": "ACT_2",
  "notes": "Layout procédural (scripts/gen-zones.mjs) — grande zone multi-écrans avec plateformes et obstacles liés aux pouvoirs.",
  "cols": 130,
  "rows": 16,
  "tiles": [
    "..................................................................................................................................",
    "..................................................................................................................................",
    "..................................................................................................................................",
    "..................................................................................................................................",
    "..................................................................................................................................",
    "..................................................................................................................................",
    ".................................####........####.................................................................................",
    "......................................................###....................................###..................................",
    "......####..................................####...............................######............#####.........#####..............",
    "...............###..........#####........................................###.........................................###..........",
    "..........###........................................................................####.............####...........#####........",
    "..................................................................................................................................",
    "..........................S......................................S...............................S................................",
    "##############...#########S...###################################S###############################S#..###########..################",
    "##############...##########...#####################################################################..###########..################",
    "##############...##########...#####################################################################..###########..################"
  ],
  "entities": [
    {
      "type": "spawn",
      "x": 2,
      "y": 12
    },
    {
      "type": "puzzle_trigger",
      "x": 28,
      "y": 8,
      "puzzleId": "puzzle_mirror_zone7_a"
    },
    {
      "type": "puzzle_trigger",
      "x": 54,
      "y": 6,
      "puzzleId": "puzzle_inverted_zone7_b"
    },
    {
      "type": "puzzle_trigger",
      "x": 80,
      "y": 7,
      "puzzleId": "puzzle_shard_zone7"
    },
    {
      "type": "boss_arena",
      "x": 110,
      "y": 12,
      "bossId": "boss_double_de_lumiere",
      "requiresCombo": "lame_duale"
    },
    {
      "type": "zone_exit",
      "x": 126,
      "y": 12,
      "targetZone": "zone8_vide_entre_deux",
      "requiresBossDefeated": "boss_double_de_lumiere"
    }
  ]
}
