{
  "id": "zone3_velkhar_foyer_ombres",
  "name": "Velkhar — Le Foyer des Ombres",
  "act": 1,
  "ambiance": "Vide noir, énergie sombre pulsante, autels rituels",
  "palette": "ACT_1",
  "notes": "Layout procédural (scripts/gen-zones.mjs) — grande zone multi-écrans avec plateformes et obstacles liés aux pouvoirs.",
  "cols": 145,
  "rows": 19,
  "tiles": [
    ".................................................................................................................................................",
    ".................................................................................................................................................",
    ".................................................................................................................................................",
    "............................................####.....###.........................................................................................",
    ".................................................................................................................................................",
    ".............................................................####................................................................................",
    ".................................................................................................................................................",
    ".................................................................................................................................................",
    "....................................................####............###.........###..............................................................",
    ".................................................................................................................................................",
    "...........................................................###...................................................................................",
    ".............................................####...........................#####........#####...................................................",
    ".................................................................................................................................................",
    "......###....#####..................................................#####........................................................................",
    "....................................####.............................................####...###....#####......####.......####....#####...........",
    ".................................................................................................................................................",
    "#################..........................V.....#....######..####.#########..................V..................................................",
    "######################..#######..##########V######....######..#########################...####V####..############..###########....###############",
    "######################..#######..#################....######..#########################...#########..############..###########....###############"
  ],
  "entities": [
    {
      "type": "spawn",
      "x": 4,
      "y": 15,
      "requiresPower": "vision_feline"
    },
    {
      "type": "npc",
      "x": 30,
      "y": 16,
      "dialogTree": "ryo_spirit_zone3",
      "requiresPower": "vision_feline"
    },
    {
      "type": "npc",
      "x": 58,
      "y": 15,
      "dialogTree": "tozen_zone3_hint"
    },
    {
      "type": "boss_arena",
      "x": 125,
      "y": 16,
      "bossId": "boss_ombre_jumelle",
      "grantsPower": "dash_fantome"
    },
    {
      "type": "zone_exit",
      "x": 140,
      "y": 16,
      "targetZone": "zone4_seikuji_quietude",
      "requiresBossDefeated": "boss_ombre_jumelle"
    },
    {
      "type": "mob",
      "x": 26,
      "y": 16,
      "tier": 1
    },
    {
      "type": "mob",
      "x": 49,
      "y": 15,
      "tier": 2
    },
    {
      "type": "mob",
      "x": 72,
      "y": 15,
      "tier": 3
    },
    {
      "type": "mob",
      "x": 95,
      "y": 16,
      "tier": 4
    },
    {
      "type": "mob",
      "x": 118,
      "y": 16,
      "tier": 5
    }
  ]
}
