{
  "id": "zone6_jardins_oublies",
  "name": "Les Jardins Oubliés",
  "act": 2,
  "ambiance": "Végétation corrompue, puzzles environnementaux",
  "palette": "ACT_2",
  "notes": "Layout procédural (scripts/gen-zones.mjs) — grande zone multi-écrans avec plateformes et obstacles liés aux pouvoirs.",
  "cols": 130,
  "rows": 16,
  "tiles": [
    "..................................................................................................................................",
    "..................................................................................................................................",
    "..................................................................................................................................",
    "..................................................................................................................................",
    "..................................................................................................................................",
    "..................................................................................................................................",
    "...............................................#####..............................................................................",
    "..................................................................................................................................",
    "............###########.#########.###................................#####..#####.......................######....................",
    "................................................................#####............#####......................###...................",
    "..............####...........................###.................###......................###....................#####............",
    "..............................####.####................................................................#####......................",
    "............................................#..######.............................................................................",
    "##############..................L....########..##########..............L..........................................................",
    "#####################...########L############..####################..##L######################..##################################",
    "#####################...#####################..####################..#########################..##################################"
  ],
  "entities": [
    {
      "type": "spawn",
      "x": 2,
      "y": 12
    },
    {
      "type": "puzzle_trigger",
      "x": 26,
      "y": 7,
      "puzzleId": "puzzle_mirror_zone6_a"
    },
    {
      "type": "puzzle_trigger",
      "x": 52,
      "y": 11,
      "puzzleId": "puzzle_anchor_zone6_b"
    },
    {
      "type": "puzzle_trigger",
      "x": 78,
      "y": 7,
      "puzzleId": "puzzle_shard_zone6"
    },
    {
      "type": "boss_arena",
      "x": 110,
      "y": 8,
      "bossId": "boss_jardinier_corrompu"
    },
    {
      "type": "zone_exit",
      "x": 126,
      "y": 13,
      "targetZone": "zone7_salle_miroirs",
      "requiresBossDefeated": "boss_jardinier_corrompu"
    }
  ]
}
