{
  "id": "zone8_vide_entre_deux",
  "name": "Le Vide entre les Deux",
  "act": 2,
  "ambiance": "Espace entre lumière et ombre, décor abstrait — boss final Malakar",
  "palette": "ACT_2",
  "notes": "Layout procédural (scripts/gen-zones.mjs) — grande zone multi-écrans avec plateformes et obstacles liés aux pouvoirs.",
  "cols": 130,
  "rows": 14,
  "tiles": [
    "..................................................................................................................................",
    "..................................................................................................................................",
    "..................................................................................................................................",
    "..................................................................................................................................",
    "..................................................................................................................................",
    ".....................................................................####.........................................................",
    ".....................................................................####.........................................................",
    "..................................................................................................................................",
    "...###....####......##...............................##.....................##...................##...............................",
    "...###....####......##...............................##.....................##...................##...............................",
    "..................................................................................................................................",
    "#############..#################....#######..###...######...######..####...####...########....##########..###..########....#######",
    "#############..#################....#######..###...######...######..####...####...########....##########..###..########....#######",
    "#############..#################....#######..###...######...######..####...####...########....##########..###..########....#######"
  ],
  "entities": [
    {
      "type": "spawn",
      "x": 3,
      "y": 10
    },
    {
      "type": "puzzle_trigger",
      "x": 31,
      "y": 10,
      "puzzleId": "puzzle_shard_zone8"
    },
    {
      "type": "npc",
      "x": 71,
      "y": 10,
      "dialogTree": "malakar_zone8_pre_boss"
    },
    {
      "type": "boss_arena",
      "x": 111,
      "y": 10,
      "bossId": "boss_malakar_final",
      "isFinalBoss": true
    },
    {
      "type": "ending_trigger",
      "x": 126,
      "y": 10,
      "requiresBossDefeated": "boss_malakar_final"
    }
  ]
}
