{
  "id": "zone6_jardins_oublies",
  "name": "Les Jardins Oubliés",
  "act": 2,
  "ambiance": "Végétation corrompue, puzzles environnementaux",
  "palette": "ACT_2",
  "notes": "Layout procédural (scripts/gen-zones.mjs) — grande zone multi-écrans avec plateformes et obstacles liés aux pouvoirs.",
  "cols": 190,
  "rows": 16,
  "tiles": [
    "..............................................................................................................................................................................................",
    "..............................................................................................................................................................................................",
    "..............................................................................................................................................................................................",
    "..............................................................................................................................................................................................",
    "..............................................................................................................................................................................................",
    "...............................######........................................................................................................................#######..........................",
    "..................................................................#######.....................................................................................................................",
    "......................####...........................................................................................................................####.....................................",
    "...........................................................####.....................................................#######...................................................................",
    "............................................................................................................................................######..............#######..............######...",
    ".............######...######.....................#####........................................................................................................................................",
    "....................................................................................................######.....................######........................................#######..........",
    "...............................................L..#..########................................................#####.........................###...#########....###########.....................",
    "##########...####....#########.............####L###..############......................................L.................................#####...#########....############..##################",
    "##########...####....##############################..######################..##########################L..##########################...#######...#########....############..##################",
    "##########...####....##############################..######################..###########################..##########################...#######...#########....############..##################"
  ],
  "entities": [
    {
      "type": "spawn",
      "x": 3,
      "y": 12
    },
    {
      "type": "npc",
      "x": 15,
      "y": 12,
      "dialogTree": "echo_hikari_zone6_hint",
      "optional": true
    },
    {
      "type": "puzzle_trigger",
      "x": 38,
      "y": 13,
      "puzzleId": "puzzle_mirror_zone6_a"
    },
    {
      "type": "puzzle_trigger",
      "x": 77,
      "y": 13,
      "puzzleId": "puzzle_anchor_zone6_b"
    },
    {
      "type": "puzzle_trigger",
      "x": 114,
      "y": 13,
      "puzzleId": "puzzle_shard_zone6"
    },
    {
      "type": "boss_arena",
      "x": 161,
      "y": 11,
      "bossId": "boss_jardinier_corrompu"
    },
    {
      "type": "zone_exit",
      "x": 184,
      "y": 12,
      "targetZone": "zone7_salle_miroirs",
      "requiresBossDefeated": "boss_jardinier_corrompu"
    }
  ]
}
