{
  "id": "zone7_salle_miroirs",
  "name": "La Salle des Miroirs",
  "act": 2,
  "ambiance": "Réflexions de Kiba, puzzles lumière/ombre, illusions",
  "palette": "ACT_2",
  "notes": "Layout procédural (scripts/gen-zones.mjs) — grande zone multi-écrans avec plateformes et obstacles liés aux pouvoirs.",
  "cols": 190,
  "rows": 16,
  "tiles": [
    "..............................................................................................................................................................................................",
    "..............................................................................................................................................................................................",
    "..............................................................................................................................................................................................",
    "..............................................................................................................................................................................................",
    "..............................................................................................................................................................................................",
    "........................................................###..................................................................................####.............................................",
    "..............................................................................................................................................................................................",
    "........................................................................................................................................................#####.................................",
    "..................................................................###.........................................................................................................................",
    "..............................................................................................................................................................................................",
    ".............................####....####........#####......................#####.............###........####...................#####...............................####......................",
    ".....####...###...###....................................#####..........................###..........................####...............###.................#####............####.............",
    ".....................................S.........................................................S..............................................S...............................................",
    "##############......##########......#S....#########################################....########S#############......########...##########...###S#####...###....###############.....############",
    "##############......##########......##....#########################################....######################......########...##########...#########...###....###############.....############",
    "##############......##########......##....#########################################....######################......########...##########...#########...###....###############.....############"
  ],
  "entities": [
    {
      "type": "spawn",
      "x": 3,
      "y": 12
    },
    {
      "type": "npc",
      "x": 19,
      "y": 10,
      "dialogTree": "reflet_zone7_intro",
      "optional": true
    },
    {
      "type": "puzzle_trigger",
      "x": 40,
      "y": 9,
      "puzzleId": "puzzle_mirror_zone7_a"
    },
    {
      "type": "puzzle_trigger",
      "x": 79,
      "y": 9,
      "puzzleId": "puzzle_inverted_zone7_b"
    },
    {
      "type": "puzzle_trigger",
      "x": 117,
      "y": 10,
      "puzzleId": "puzzle_shard_zone7"
    },
    {
      "type": "boss_arena",
      "x": 161,
      "y": 12,
      "bossId": "boss_double_de_lumiere",
      "requiresCombo": "lame_duale"
    },
    {
      "type": "zone_exit",
      "x": 184,
      "y": 12,
      "targetZone": "zone8_vide_entre_deux",
      "requiresBossDefeated": "boss_double_de_lumiere"
    }
  ]
}
