{
  "id": "zone5_seikuji_corrompu",
  "name": "Seikūji Corrompu",
  "act": 2,
  "ambiance": "Mélange lumière brisée / ombre envahissante",
  "palette": "ACT_2",
  "notes": "Layout procédural (scripts/gen-zones.mjs) — grande zone multi-écrans avec plateformes et obstacles liés aux pouvoirs.",
  "cols": 160,
  "rows": 15,
  "tiles": [
    "................................................................................................................................................................",
    "................................................................................................................................................................",
    "................................................................................................................................................................",
    "................................................................................................................................................................",
    "................................................................................................................................###.............................",
    "................................................................................................................................................................",
    ".............................####...............................................................................................................................",
    "...........#####...................................................................................###................................###.......................",
    "................................................................................................................................................................",
    ".............................####....####............................................###........................................................................",
    ".....................#####.......................................####......#####...........#####..........###...####........#####.............###...............",
    "................................................L...............................................L...............................................................",
    "#########....##################....#############L....######...################....##############L....#####...################################...################",
    "#########....##################....##############....######...################....###############....#####...################################...################",
    "#########....##################....##############....######...################....###############....#####...################################...################"
  ],
  "entities": [
    {
      "type": "spawn",
      "x": 4,
      "y": 11
    },
    {
      "type": "npc",
      "x": 24,
      "y": 11,
      "dialogTree": "echo_hikari_zone5_intro"
    },
    {
      "type": "puzzle_trigger",
      "x": 82,
      "y": 11,
      "puzzleId": "puzzle_shard_zone5"
    },
    {
      "type": "zone_exit",
      "x": 155,
      "y": 11,
      "targetZone": "zone6_jardins_oublies"
    }
  ]
}
