{
  "id": "zone4_seikuji_quietude",
  "name": "Seikūji — Le Temple de la Quiétude",
  "act": 1,
  "ambiance": "Sommet, au-dessus des nuages. Blanc et doré, silence absolu, lumière diffuse",
  "palette": "ACT_1",
  "notes": "Layout procédural (scripts/gen-zones.mjs) — grande zone multi-écrans avec plateformes et obstacles liés aux pouvoirs.",
  "cols": 160,
  "rows": 16,
  "tiles": [
    "................................................................................................................................................................",
    "................................................................................................................................................................",
    "................................................................................................................................................................",
    "................................................................................................................................................................",
    "..........................................................................................................................####..................................",
    "................................................................................................................................................................",
    "................................................................................................................................................................",
    ".....................................................................................................................................######.....................",
    "................................................................................................................................................................",
    "................................................................................................................................................................",
    "......#######...............#####.....#######.........####.......####.....####..............................######...####.....................####...####.......",
    "................................................................................................................................................................",
    "................................D...............................D...............................D...............................D...............................",
    "####################...#########D###############################D#############..#############...D#################...###..######D...############################",
    "####################...#######################################################..#############...##################...###..#######...############################",
    "####################...#######################################################..#############...##################...###..#######...############################"
  ],
  "entities": [
    {
      "type": "spawn",
      "x": 4,
      "y": 12,
      "requiresPower": "dash_fantome"
    },
    {
      "type": "npc",
      "x": 16,
      "y": 12,
      "dialogTree": "veilleur_zone4_intro",
      "optional": true
    },
    {
      "type": "boss_arena",
      "x": 72,
      "y": 12,
      "bossId": "boss_velkhar_ancien",
      "grantsPower": "forme_ombre"
    },
    {
      "type": "power_altar",
      "x": 144,
      "y": 12,
      "altarId": "hikari_no_ne",
      "requiresPower": "forme_ombre",
      "pivotEvent": true,
      "grantsPower": "eclat_lumiere"
    },
    {
      "type": "zone_exit",
      "x": 156,
      "y": 12,
      "targetZone": "zone5_seikuji_corrompu",
      "requiresAltar": "hikari_no_ne"
    }
  ]
}
